    #####             
    #   #             
    #   #             
  ###   ###           
  #       #           
### # ### #     ######
#   # ### #######    #
#   OX               #
##### #### # ####   P#
    #      ###  ######
    ########          
