    #####             
    #   #             
    # X #             
  ###   ###           
  #O      #           
### # ### #     ######
#   # ### #######    #
#   OX               #
##### #### # ####   P#
    #  OX  ###  ######
    ########          
