    #####             
    # X #             
    #   #             
  ###   ###           
  #       #           
### # ### #     ######
#   # ### #######    #
#   OX               #
##### #### # ####   P#
    #  O   ###  ######
    ########          
